########
#FFFFFF#
#FBB@FF#####
#F#FFFFFFFF#
#FFFPFFFBFF#
#FFFPFFFFFF#
#FFFFFF###F#
#FFFF#FFFFF#
#FFFF#FFFFF#
#FFFFFFFFFP#
############