########
#FFFFFF#
#FBB@FF#####
#F#FFFFFFFF#
#FFFPFFFFFF#####
#FFFPFFFFBFFFFF#
#FFFFBF##FFFFFP####
#FFFF#FFFFFFFFF#
#FFFF#FFFFF#####
#FFFFFFFFFP#
############