#################
#FFFFFFFFFFFFFFF#
#FFFFFFFFFFBFFFF#
#FFFFFFPFFFBFFFF#
#FFFFFFPFFFBFFFF#
#FFFFFFPFFFBFFFF#
#FFFFFFPFFFBFFFF#
#FFFFFFPFFFBFFFF#
#FFFFFFPFFFFFFFF#
#FFFFFF@FFFFFFFF#
#################
